NO             ./image/NO.xpm       		
SO                   ./image/SO.xpm      
WE ./image/WE.xpm
EA ./image/EA.xpm

F 100,100,0
C 100,30,0

1111
1S01
1001
1111