NO             ./image/NO.xpm       		
SO                   ./image/SO.xpm      
WE ./image/WE.xpm
EA ./image/EA.xpm

F 220,100,0
C 225,30,0

1111111
1100N01
1100011
1111111
