NO             ./image/NO.xpm       		
SO                   ./image/SO.xpm      
WE ./image/WE.xpm
EA ./image/EA.xpm

F 220,100,0
C 225,30,0

        1111111111111111111111111
        10000000001100000000000011
        10110000011100000000000011
        10010000000000000000000011
111111111011000001110000000000001
100000000011000001110111111111111
11110111111111011100000010001
11110111111111011101010010001
11000000110101011100000010001
10000000000000001100000010001
10000000000000011101010000001
1100000111010101 11100000N001
11110111 1110101 101111000001
11111111 1111111 111111111111
